size: 32x42

tiles: 4
0 - sand - false
1 - rock - true
2 - water - true
3 - grass - false

spawn: 14,8

layout:
3 3 3 3 1 1 1 1 1 1 1 1 1 0 0 0 0 0 0 0 2 2 2 2 2 2 2 2 2 2 2 2
3 3 3 3 1 1 1 1 1 1 1 1 1 1 1 0 0 0 0 0 2 2 2 2 2 2 2 2 2 2 2 2
3 3 3 3 1 1 1 1 1 1 1 1 1 1 1 1 0 0 0 0 2 2 2 2 2 2 2 2 2 2 2 2
3 3 3 3 1 1 1 1 1 1 1 1 1 1 1 1 0 0 0 0 2 2 2 2 2 2 2 2 2 2 2 2
3 3 3 3 1 1 1 1 1 1 1 1 1 1 1 1 0 0 0 0 0 2 2 2 2 2 2 2 2 2 2 2
3 3 3 3 1 1 1 1 1 1 1 1 1 1 0 1 1 1 0 0 0 2 2 2 2 2 2 2 2 2 2 2
3 3 3 3 1 1 1 1 1 1 1 1 1 0 0 0 1 1 1 0 0 2 2 2 2 2 2 2 2 2 2 2
3 3 3 3 1 1 1 1 1 1 1 1 1 0 0 0 0 0 1 1 0 2 2 2 2 2 2 2 2 2 2 2
3 3 3 3 1 1 1 1 1 1 1 1 0 0 0 0 0 0 0 0 2 2 2 2 2 2 2 2 2 2 2 2
3 3 3 3 1 1 1 1 1 1 0 0 0 0 0 0 0 0 0 2 2 2 2 2 2 2 2 2 2 2 2 2
3 3 3 3 1 1 1 1 1 0 0 0 0 0 0 0 0 0 0 2 2 2 2 2 2 2 2 2 2 2 2 2
3 3 3 3 1 1 1 1 1 0 0 0 0 0 0 0 0 0 0 2 2 2 2 2 2 2 2 2 2 2 2 2
3 3 3 3 1 1 1 1 1 0 0 0 0 0 0 0 0 0 0 0 2 2 2 2 2 2 2 2 2 2 2 2
3 3 3 3 1 1 1 1 1 0 0 0 0 0 0 0 0 0 0 0 2 2 2 2 2 2 2 2 2 2 2 2
3 3 3 3 1 1 1 1 1 0 0 0 0 0 0 0 0 0 0 2 2 2 2 2 2 2 2 2 2 2 2 2
3 3 3 3 1 1 1 1 1 0 0 0 0 0 0 0 0 0 0 2 2 2 2 2 2 2 2 2 2 2 2 2
3 3 3 3 1 1 1 1 1 0 0 0 0 0 1 0 0 0 2 2 2 2 2 2 2 2 2 2 2 2 2 2
3 3 3 3 1 1 1 1 1 0 0 0 0 0 0 0 0 0 2 2 2 2 2 2 2 2 2 2 2 2 2 2
3 3 3 3 1 1 1 1 1 0 0 0 0 0 0 0 0 0 2 2 2 2 2 2 2 2 2 2 2 2 2 2
3 3 3 3 1 1 1 1 0 0 0 0 0 0 0 0 0 0 2 2 2 2 2 2 2 2 2 2 2 2 2 2
3 3 3 3 1 1 1 1 0 0 0 0 0 0 0 0 0 0 2 2 2 2 2 2 2 2 2 2 2 2 2 2
3 3 3 3 1 1 1 1 0 0 0 0 0 0 0 0 0 2 2 2 2 2 2 2 2 2 2 2 2 2 2 2
3 3 3 3 1 1 1 1 0 0 0 0 0 0 0 0 0 2 2 2 2 2 2 2 2 2 2 2 2 2 2 2
3 3 3 3 1 1 1 1 0 0 0 0 0 0 0 0 0 2 2 2 2 2 2 2 2 2 2 2 2 2 2 2
3 3 3 3 1 1 1 1 1 0 0 1 0 0 0 0 0 2 2 2 2 2 2 2 2 2 2 2 2 2 2 2
3 3 3 3 1 1 1 1 1 0 0 0 0 0 0 0 0 0 2 2 2 2 2 2 2 2 2 2 2 2 2 2
3 3 3 3 1 1 1 1 1 0 0 0 0 0 0 0 0 0 2 2 2 2 2 2 2 2 2 2 2 2 2 2
3 3 3 3 1 1 1 1 1 0 0 0 0 0 0 0 0 0 2 2 2 2 2 2 2 2 2 2 2 2 2 2
3 3 3 3 1 1 1 1 1 0 0 0 0 0 0 0 0 0 0 2 2 2 2 2 2 2 2 2 2 2 2 2
3 3 3 3 1 1 1 1 1 0 0 0 0 0 0 0 0 0 0 2 2 2 2 2 2 2 2 2 2 2 2 2
3 3 3 3 1 1 1 1 1 0 0 0 0 1 0 0 0 0 0 0 2 2 2 2 2 2 2 2 2 2 2 2
3 3 3 3 1 1 1 1 1 0 0 0 1 1 0 0 0 0 0 0 2 2 2 2 2 2 2 2 2 2 2 2
3 3 3 3 1 1 1 1 1 0 0 0 1 1 1 0 0 0 0 0 2 2 2 2 2 2 2 2 2 2 2 2
3 3 3 3 1 1 1 1 0 0 0 1 1 1 0 0 0 0 0 0 2 2 2 2 2 2 2 2 2 2 2 2
3 3 3 3 1 1 1 1 0 0 0 1 1 0 0 0 0 0 0 2 2 2 2 2 2 2 2 2 2 2 2 2
3 3 3 3 1 1 1 1 0 0 0 0 0 0 0 0 0 1 1 0 0 2 2 2 2 2 2 2 2 2 2 2
3 3 3 3 1 1 1 1 1 1 0 0 0 0 0 1 1 1 1 1 0 0 2 2 2 2 2 2 2 2 2 2
3 3 3 3 1 1 1 1 1 1 1 1 1 1 1 1 1 0 0 0 0 0 2 2 2 2 2 2 2 2 2 2
3 3 3 3 1 1 1 1 1 1 1 1 1 1 1 1 1 0 0 0 0 0 0 2 2 2 2 2 2 2 2 2
3 3 3 3 1 1 1 1 1 1 1 1 1 1 1 1 0 0 0 0 0 0 0 2 2 2 2 2 2 2 2 2
3 3 3 3 1 1 1 1 1 1 1 1 1 1 1 0 0 0 0 0 0 0 2 2 2 2 2 2 2 2 2 2
3 3 3 3 1 1 1 1 1 1 1 1 0 0 0 0 0 0 0 0 0 0 2 2 2 2 2 2 2 2 2 2