1111111111111111
1000000100013331
1000220110113331
1000000000000001
1011111222101101
1010001000101001
1000100010001001
1111111111111111