1111111111111111
1000000100000001
1000000000000001
1000000100000001
1111111100000001
1000000000010001
1000000000000001
1111111111111111