size: 7x32

tiles: 4
0 - grass - false
1 - rock - true
2 - water - true
3 - sand - false

spawn: 3,2

layout:
1 1 1 1 1 1 1
1 0 0 0 0 0 1
1 0 0 3 0 0 1
1 0 0 3 0 0 1
1 0 0 3 0 0 1
1 0 0 3 0 0 1
1 0 0 3 0 0 1
1 0 0 3 0 0 1
1 0 0 3 0 0 1
1 0 0 3 0 0 1
1 0 0 3 0 0 1
1 0 0 3 0 0 1
1 0 0 3 0 0 1
1 0 0 3 0 0 1
1 0 0 3 0 0 1
1 0 0 3 0 0 1
1 0 0 3 0 0 1
1 0 0 3 0 0 1
1 0 0 3 0 0 1
1 0 0 3 0 0 1
1 0 0 3 0 0 1
1 0 0 3 0 0 1
1 0 0 3 0 0 1
1 0 0 3 0 0 1
1 0 0 3 0 0 1
1 0 0 3 0 0 1
1 0 0 3 0 0 1
1 0 0 3 0 0 1
1 0 0 3 0 0 1
1 0 0 3 0 0 1
1 0 0 0 0 0 1
1 1 1 1 1 1 1